NO ./32textures/bricks.xpm
SO ./32textures/dirt.xpm
WE ./32textures/gold.xpm
EA ./32textures/stone.xpm
F 220,100,0
C 225,30,0
111111111111111111111111111111
111000000000000000110000000001
110000000011000001110000000001
111000000001000000000000000001
111111100011000001110000000001
100000000011000000001100111001
111101001110111000000100011001
111101001110111010100100011001
110000001101010111000100011001
100000000000000011000000011001
100000000000000011000100011001
11000001110101011011110N011001
011100000000111011110100011001
111111111111111111111111111111